############################################################################################################################################################################################################################
# # #       #         #                     #       #         #                   #     #           # #           #   #   #           #       #   #           #         #   #     #     #   #     #       #     #   #       #
# # # ### ### # ##### ### # ##### ######### # # ### ##### ### # ####### ### ##### # ### # ######### # # ####### # # # # # # ### ##### # ##### # # # ##### # ### ##### # # # ### # ##### # # # # # # # ##### # # # # ####### #
# # #   #     # #   #   # #     # #   #   # # # # #       #   #   #   # # #   # # #   # #     #     #     #     #   # # # #   # #   # #     # # #   #   # #   # # #   #   #     #     # # #   # # # #       # # # #       # #
# # ### ####### ### ### # ##### ### # # # # ### # ######### ##### # # # # ### # # # # # ### # ### ######### ######### # # ##### # # # ##### # ####### # ### # # # # ################# # # ##### # ####### ### # # ####### # #
# #     #     #   #   # #     #     # # # # #   #         #   #   # # #     # # # # # #   # #   #           #     #   # #     #   # #       #         #   # # #   # #   #         #   #     #   #   #   # #   #   #   #   # #
# # ##### ### ### # # # ##### ####### # # # # ##### ##### ### # ### # ##### # # # ### ### # ### ############# # ### ### ##### # ### ##################### ### ### # # # ### ##### # ####### # ##### # # ### ######### # ### #
# # #     #   #   # # # #   #       # # #   # #   # # #   #   # # # #     # # # # #   #   #   # #           # #     #   #   # #   # #     #     #       #   #     #   #   # #   #   #     # # #   # # #   # #       # #   # #
# ### ##### ### ### ### # # ####### # ##### # # # # # # ### ### # # ##### # # # # # ### ##### # ### ##### ### ####### ### ### ### # # ### # ##### ##### ### ####### ##### # ### ##### ### ### # # # # ### # # ##### # ### # #
#     # #   #     #   # # #   # #   #     # # # # # #     # # #   #   #   # # #   # #   #   # #   #   #   #   #     #   #   # #   # # #   # #         #   #       #     # #       #   # #     # # # # # # #       # #       #
####### # ### ### # # # # ### # # ####### # # # # # # ##### # # ##### # ##### # ### # ##### # ### ### # # # ### ### # # ### # # ### # ### # # ####### ### ####### ##### # ####### # ### ####### # # # # # ### ##### # #######
#     # # #   #   # #     # # # # #     # #   # #   # #     #   #     # #     # #   #     #   #   # # # # # #     # # #   #   # #   #   # #     #   #   #   #   #   # # # #   # #   #       #   # #   # #   # #     #   #   #
### # # # # ### # ######### # # # # ### # ##### ##### # ##### ### ##### # ##### # # ##### ##### ### # # ### ##### ### ### # ### # ##### # ####### # ### # # ### ### # # # # # # ######### # ##### ##### ### ### ######### # #
#   #   # # #   # #     # #   # # # #   #     #   #   #   #     # #   #   # #   # # #   #     # # #   #     #   #     # # # #   # #     #     #   #   # # #   #   # # # #   # # #       # #               #   #     #     # #
# # ##### ### # ### ### # # ### # ### # ##### ### ### ### ##### # # # ##### # ##### ### ##### # # # ######### # ##### # # # # ### # # ####### # ##### ### ### ### # # # ##### # # # ### # ### ############### ##### # ##### #
# # #     #   # #   #   # # #         # #   #   #   #   # #   # # # #   #   #     # #     #   # # #   #   #   #     #   # # #   # # #   #   #   #   #     #       # #   #   # # # # #     #   #       #     # #     #   #   #
# ### ##### ##### ### ### # ########### # # ### # # ### # # # ### # # # # # ##### # # ##### ### # ### ### # # ##### ##### # ##### ##### # ####### ####### ##### ### # ### # # # # # ########### ##### # ### # # # ##### # ###
#   #     #       #   #   #   #     #     # #   # # #   # # # #   # # # # # #       # #   # #   #   #   #   #   #   #   # #     #   #   #       #         #   # #   # #   # # #   #     #         #   #   #   # # #   # #   #
# # ##### ######### ##### ### # ### ######### ### # # ### # # # ##### ### # # ####### # # # ### # ##### # ##### # ### # # ##### ### # ### ##### # ######### # ### ### # ### # ######### # ##### ### # ### ##### ### # # ### #
# #     #           #     # #   # #         #   # # #   #   # # #     #   #     #   #   # # #   #       #   #   # #   #   #   #     #   #     # # # #       #   # #   # #   #         #   #   # #   #   # #         #   #   #
### ### ############# ### # ##### ######### ### ### ######### # # ##### ##### ### # # ### # # ### ########### ### # ######### ####### # ##### # # # # ######### # # ### # ####### ### # ### # # # ####### ##### ######### # #
#   # #     #   #   # #     #   #       #   #   #   #         # #       #   # #   # #   # # #   # #           #   #     #   #   #   # # #   # # # # # #   #     # #   # #       #   # # #   # # # #     # #   #   #     # # #
# ### ##### # # # # # ##### # # # # ##### ### ### ### ######### # ##### # # ### ### ### # # ### # # ### ####### ####### # # # ### # # # # ### # # # # ### # ##### ### # ####### ##### ### ### ### # ### # # # ### # ### # ###
# #     # #   #   # #   #   # #   #     # #   #       #   #     # #   # # #     #   #   #       # # #   # #     #       # # #   # #   # #     # #   #     #       #   # #     # #     #   #     # # # #   # #   # #   # #   #
# # # # # ######### # # # ### ######### # ### # ####### ### ### # # # ### ####### ############### ### ### # ##### ####### # # # # ##### # ##### ### ##### ############# ##### # # ##### ####### # # # ##### ### # ### ##### #
# # # # # #       # # # # #   #     #   #     #       #     # # # # #     #     #         # #   #     #   # #     #   #   # # #     #   # #   #   # # #   #           # #   #     #   #     #   # # #       # # #   #     # #
# ### # # # ### ### ### ### ### ### # ############### ### ### # ### ######### # ######### # # # ####### ### # ### # # # # # ####### # ### # # ### # # # ########### # # # # ####### # ##### ### # # ##### # # # ### ### # # #
#   # #   # #   #   #   #   #   #   #         #     #   #     #   # #       # #   #       #   #       #   # #   #   # # # #     #   # #   # #   #   # #         #   # #   #         # #   #   #   # #   # # # # #       # # #
### # ##### # ### ### ### ##### # ##### ### ### # ##### ######### # # ##### # ##### ############### ### # # ######### # # ##### ##### # ##### # ##### ######### # ### ### ########### # # ### ##### # # ### # # ######### # #
#   # #     #     #   #   #     # #   # #   #   #     # #         #   #   # # #     # #             #   # #       #   # #     #       #       #   #           # # #     #   #       # # #   #     # # #     # #         # # #
# ### # ############# # ### ##### # ### ##### ##### ### # ############### # # # ##### # ### ### ##### ### ####### # ### ##### # ##### ########### ######### ### # ##### ##### ##### # # ### ##### # # ####### ######### # # #
# #   #     # #     # #     #   # #   #       #   #     #                 #   #     #   # #   # #   #   #       #   # # # #   # #   # #     #               #   #   # # #   #   #     # #         # #   #     #       # # # #
# # # ##### # # # # # ####### # # ### ######### ######### ######### ##### ### ##### ### # ### ### # ### # ########### # # # ##### # ### ### ############### # ### # # # # # ### ####### ########### ### # ### ### # ### # # #
# # #     # #   # # #   #     # #   #   #       #   #     #   #   #   #     #     #   # #   # #   # #   # #     #     #   #     # #     # #     #     #   # # #   # #     #   #   #   #   #       # #   # #       # #   # # #
# ####### # # ### # # # # ### ##### ### # ### ### # # ##### # # ##### ### ### ####### # # # # # ### # ### # ### # # ### ####### # ####### ##### # ##### # # # # ### ######### ### # # # # # ##### # # ### ######### # ##### #
#       # # # #   #   # #   # #   #   #   #   #   # # #     # # #   #   # #   #     # # # # #   # # #   # # # #   #   # #     # #   #         # #       # # # #   #     # #   #   # #   #     #   # # #     #     # # #   # #
# ##### # # ### ####### ### ### # ### # ### ### ### # ##### # # # # ### ### ### ### # # # # ##### # ### # # # ####### # # ### # ### # ######### ######### # # ######### # # ### ######### ##### ### # # ### # # ### # # # # #
#   # # #       #         # #   #     # # #   #   #         # #   #   #     # #   #   #   #       #   # #   #       # # # #       # # #       #         #   # #         #   #   #       # #   #   # # #   # # #   # #   #   #
### # # ####### ######### # # ######### # ### # ############# # ### # ####### ### ########### ##### # # ##### # ##### # # ##### ### # # ##### ######### # ### # ######### ### ### ##### ### # ### # # ### # # ### # ####### #
# #   #     #   #     # #   # #     # #     #   #     #     # # #   # #       # # #     #   # #     # # #   # # #     # #   #   #   #   #   #     #     #   # # #   #     #   #   #   # #   #     # # #   # #   #   #     # #
# ### ##### ##### ### # ### # # ### # ### ####### ### ##### # # # ### # ##### # # ##### # # # # ##### # ### # # # ##### ### # ### ### ##### ##### # ######### # # # # ##### ### # # # # # # ##### # # ##### ### ##### ### # #
#     #   # #     #   #     #   #   #     #   #   # # #   # # # # #     #     # #   #   # #   #   #   # #   # # #       #   # #   # #           # # #   #   # # # # # # #   #   # # #     # #   # # #   #   #     #   #   # #
# ##### # # # ##### # ########### ### ##### # # ### # # # # # ### ### ####### # ### # ### ####### # ### # ### # ######### ### # ### ########### # # # # # # # # # ### # # # # ### ########### # ### # # # ####### ##### ### #
# #     # # #   #   # #     #     #   #     # # #   #   # #     #   # #     #     # # #     #   # #   # # #   #         # #   #   #   #     #   # #   # # # #   #     #   # #   #       #     #   # # # #     # # #     #   #
# ####### # ### # ##### ### # ######### ##### # # # ##### ##### ### # # ### ### ### # # ##### # # ### # # # ### # ####### # ##### # # # # ### ### ##### # # ##### ##### ### ### ####### # ####### # ### # ### # # # # ### ###
#     #   # #   #       # #   #       #   # #   # #     #   #   #   # #   # # # #   #     #   #   # # # #   #   # #   #   #     # # #   #   #   #     #   #     #     #   #   #     #   #       # # #   # #   #     # #   # #
##### # # # # ########### ####### ### # # # ##### ##### ### # ### ##### ### # # # ####### # ####### # # ### # ### # # # # ####### # ####### ### # ############# ##### ### ### ##### # # ####### # # # ##### ######### # ### #
#   #   # # # #             #     #   # # #   #       #   # #   #       #   #   # #     # #     # #   #   # # #   # #   # #   #   #   #   #     # #       #   #   #   #     #     # # # #     # #   #     # #     #   #   # #
### ##### # # # ##### ####### # ### ##### # ### ##### ##### ### ######### ### ### # ### # ##### # # ##### ### ##### ####### # # ##### # ######### # # ##### # # ### ####### ##### ### ### ### # ######### # # ### ####### # #
#     # # #   # #   #   #     # # #     # #   # #   # #     #   #   #   # #   #   # # # # #     # # #   #   #   #   #   #   # # #   #   #       # # #       # #     #   #     #   #   #   # #   #         #   # #           #
# ### # # ##### # # ### # ##### # ##### # # # # # ### # ##### ### # # # # # ### # # # # ### ##### # # # ### ### # ### # # ### # # # ### # ##### # # ######### ####### # ####### ### # # ### ##### ######### ### #############
#   #   # #   # # #   #   #   # #     #   # #   #   #   #     #   #   #   # # # # # # #   # #         #   #   # #   # #   #   # # #     # #   # #   #   #   # #       #         #   # # #         #     # #     #           #
### ##### # ### # # ####### # # ### # ##### ##### # ####### ##### ######### # # ### # ### # # ####### ####### # ### # ##### ### # ####### # # # # ### # ### # # # ############### # # # # # ####### ### # ##### # ######### #
#   #   # #   # # # #     # # # #   #     # #     #   #   #     # #       # # #         # # #   #   # #     #   # # # #   #   # # #     # # # # #     #     #   #   #     #   #   # # # # #         #   # #   # #   #     # #
# ### # # # # # # ### ### # # # # ####### # ####### # # # ##### # ####### # # ######### # # ##### # ### ### ### # # # # # ### # # ##### # ### # ######### ######### # # ### # # ### ### ####### ##### ### # # # ### # ### # #
#   # #   # #   #   # #     #   #   #     #       # #   #   #   #   #   # #   # #     # # # #     #   # # #   #   #   # #   #   #       #   #   #   #   # #   #   # # #   # #     #   #       # #     #   # # #   # #   # # #
# # # ##### ##### # # ########### # ############# # ####### # ### # # # # ### # # ### ### # # ####### # # ### ### ##### # # ########### ### ### # ### # # # # # # # # ### # ######### ####### # # ####### # # # ### ##### # #
# # #   # # #     # #   #       # #       #     # #   # #   #   # #   # # #   # # #   #   #         # # #   # #   #     # # #         #   #   # #     # # # #   #   #   #   # #     #     # # # # #     #   # # #   #     # #
# # ### # # ####### ### # # ##### ####### # ### # ### # # ##### ####### # # ### # # ### ########### # # ### # # ######### # # ####### ####### # ##### # # # ########### ##### # ### # ### # # ### # ### ##### # # ### # ### #
# #   # # #     #     # # #     #   #   #   #   #   # #       # #   #   #   #   # # #   #     # #   #   #   #   #         # # #   #   #       #     # #   # #   #   #   #     #   # #   # # # #   #   #     #   #     # #   #
# ### # # ##### # # ### # ##### ### ### ##### # ### # ####### # # # # ### ##### # # # ### ### # # ####### # ##### ######### # ### # ### ########### ####### # # ### # ### ### ### # ### # # # # ##### ##### ########### # ###
#   #   #         # #   # # #     #   #     # # #   #     #   #   #   #         # #   #   # # # # # #     #     # #         #   #   #   #       #   #     # # #     # # # #   #   #     #   # #   #   #   #             #   #
### ############### # ### # # ####### ##### # ### ####### # ########### ####### # ##### ### # # # # # # ####### # ##### ####### # ##### # ### # # ### ### # # # ##### # # # # # ############# # # # ### ####### ####### ### #
# # #             # #   #   # #       #   # #     #       # #     #     #     # # #         # #   #   #   #   # # #   #         #   #   #   # # #     # #   # # #   # #   # # #         #   # # #   #   #     # #     # #   #
# # # ########### # ### ### # # ####### # # ######### ##### # ### # ##### ### # # # ######### # ######### # # # # # # ### ######### # ### ### ######### ##### ### # # ##### # ######### # # # ### ### # # ### ### ### ### # #
#   # #     #   # #   #   # #   #       #   # #       #       #   # #     #   # #   #     #   #           # # # #   #   # #   #   # # #   #   #           #       #   #     #   #     #   # #   #   # # # # #     # #     # #
# ### # ### # # # ####### # ##### ######### # # ### ########### ##### ##### ### ##### ### # ################# # ### ### ### # # # # # # ### # # ##### # ### ########### ####### ##### ##### ### ### # ### # ####### ####### #
#   #   #   # # #         #   #   #       #   #   # #       # #       #   #   #   #   #     #       #       # #   # # # #   # # # #   # #   # # # #   # #           #   #     #   #       #   #   # #   # #       #         #
### ##### # # # ############# ### # # ####### ### # # ##### # ######### # ### ### # ### ##### ##### # # ### # ### # # # # ### # # ####### ##### # # ### # ######### ### # ### ### # ######### ### # ### # # ### ### #########
# #     # # # #   #     #   #   # # # #         # # # # #   #           #   # # # # #   #   #   # #   #   #   #   # # # # #   # #         #     # # #   #   #   #       #   #   # # #   #   # #   # #   # #   #   #   #     #
# ##### # ### ### # ##### # ### # # # # ######### # # # # ### ######### ##### # # # # ### # ### # ##### # ##### ### # # # # ######### # # # ##### # # ##### # # # ######### ### # # # # # # # # ### # # # ####### ### ##### #
# #     # #     # #   #   # #   # # #     #       # # # # #     #       #     #   # #   # #   #   #   # #     # #     #   # #       # # # #       # # #     # # # #       #   # #   # #   #   # # #   # #   #   # #         #
# # ##### # ##### # # # ### # ### ######### ####### # # # ### ### ##### # ##### ### ##### ### ##### # # ##### # ##### ##### # ##### # # ##### ##### ### ##### # ### ##### # # ### ### ####### # # ##### ### # # # # #########
# #   #       #   # #   # #   #   #     #       #   #   #   # #   #     # #     #   #   #   #     # # #     # #     #   # # #     # # # #     #   #     # #   #   #   #   # #     #   #       # #       # #   # #     #     #
# ### # ####### ### ##### ##### # # ### # ####### ### ##### # # ######### # ##### ### # # ####### # # ##### # ##### ### # # ##### # # # # ##### # # ##### # ##### ### # ### ####### ##### ##### # ####### ##### ####### ### #
#   # #   #     #   #     #     # # # #   # #   #   # #     # # #         # #   # #   #   #   #   # #   #   # #     #   # #   #   # # # # #   # # #     # # #   #     #   # #     #     # # #   #       #   #   #         # #
### # ##### ##### ### ### ####### # # ##### # # # # # # ####### # ######### # # # # ####### # # ### ### # ### # ##### ### # # # ### ### # ### # # ##### # # ### ######### # # ### ##### # # # ######### # # # ### ####### # #
#   #       #   # #     #       #     #     # # # #   # #       # #         # # #   #       # # #   # # #   #       # #   # # #   #   #       # #     #   #   #       #   # # #   #   # #   #     #   #   # #       #   # # #
# ########### # # ### # ####### ##### # # ### # # ##### # # ##### ####### ### # ##### ####### # # ### # ### ####### # ### # ##### ### # ##### # ##### ####### ##### # # ##### # ### # # ######### ### ##### ######### # ### #
# #         # # #   # # #     #     #   # #   # # # #   # # #   #   #   # #   #     # #         #   # #   # #   #   #     #   #   #   # #   # # #     #       #   # # #   #   # #   #   #   #     #   # #   #     #   #     #
# # ### ### ### ### ### # ######### ##### # ### # # # ##### # # ### # # # # ##### ### # ########### # ### ### # # ####### ### # ### ##### # ### # ### # ####### # ### ### # ### # # ##### # # ##### # # # ### ### # ####### #
#     # #         #     # #       #     # # #   #   #     #   #   #   # # #   #   #   # #     #     #   #     # #       #   # # # # #     #     #   # #     #   #       #   #   # # #     # # #     #   #     #   # # #     #
# ##### # ############### # # ######### ### # ########### # ### # ##### # ##### # # ### # ##### ####### ####### ####### ##### # # # # ############# # ##### ### ########### # ### ### ##### # # ############### ### # # #####
#   #   # #               # #       # #     #   #   #     # # # # #   # #       # # #     #     #           #   #     #     #     #           #   # # #   # #   #   #     # # #   #   #   #   #           #     # # # #   # #
### # ### # ##### ### ##### ##### # # ######### # # # ##### # # # ### # ######### # ####### ##### ### # ##### ### ### ##### # ############### # # # # ### # # ### # # ### ### ### # ### # ##### ######### # ##### # # ### # #
#   # #   #   # # #   #     #     #   #         # #   #   #   # #     #         # #       # #       # # #     # #   #     # # #     #       # # #   #     # #     # # # #     #   # #   # #         #   # #       # #   # # #
# ### # ##### # # # ### ##### # ####### ######### ##### # ##### ############### ######### # # ####### ### ##### ### ### ### ### ### # ##### ### ########### # ##### # # ####### # # # ##### ####### ### # ### ##### # ### # #
#   # # # #   # # #   #     # # #     # #         #     # #     #           #   #         # # #       #   #       # # # #   #   # #   #   #   #   #   #     # # #   # #         # # # #     #     #   # #     #     #   # # #
### # # # # ### # ####### ### # # ### # # ##### ### ### # # ##### ####### ### ### ####### # ### ##### # ##### ##### # # # ### ### ##### ##### ### # # # ##### # # ### ######### ### # # ##### ### ### # ####### ####### # # #
#   # #   #   # #         #   # # # #   # #   #   #   # # # #     #     #   # #     #     #   # #     # #   #     #   #   #   #       #     #   # # # #   #   # #   #         #   # # # #   # #   #     #     #       # #   #
# ### # ##### # ########### ##### # ##### # # ### ### # # # # ##### ### ### # ##### # ####### # ####### # # ### # ### ##### ##### # ### # ##### # # # ### ### # ### ######### ### # # # ### # # ####### # ########### # ### #
# # # # #   # #     #     #     #       # # # #   #   # #   #     #   #   # #   #   # #   #     #   #   # #   # # #   #   #     # #     #       # # #   #   #   #   #   # #   #   # # #     # # #     #   #           # #   #
# # # ### # # ### # # ### ##### ####### ### # # ####### ### ##### ### ### # ### # ##### # # ##### # # ### ### ### # ### # # ### # ############### # ### ### # ### # # # # # ### ### # ### ### # # ### ### # ########### # ###
#   #     # #     #   # # #   #       #   # #   #     #   #     #   #   # #   # #     # #   #     #   #   #   #   #     # #   # # # #       #     # # #   # # #   #   #   #   #   # #     #   #   # # #   # #   #         # #
### ####### ########### # # # ##### ##### # ##### ### # # ######### # ### ### # ##### # ##### ######### # ### # ######### ##### # # # # ### ### ### # ### # ### ############# ### # ##### # ####### # ##### # # # ######### #
# #   #   #     #         # #   #   #   #   #     #   # #   #       # #     # #     #       #   #     # #   #   #         #     # #   # # #   #   # #   # # #   #             #   #     # #   #     #     # # # #     #     #
# ### # ####### # ######### ### # ### # ##### # ### ### ### # ####### # ### # ##### ########### # # ### ### # ### ######### ##### ### # # ### # # # # # # # # # # ############# ####### ##### # ### ##### # # # ##### ##### #
#   # # #       #   #     # #     #   #     # #   # # # #   # #       #   # #   # #             # # #     # # #   # #       #   #   # # #     # # #   # #   # # # #       #   #       #       #   # #     # # #             #
# # # # # ######### # ### # ##### # ### ##### ### # # # # ### ######### # ### # # ############### # # ##### ### ### # ### ### ##### ### # ##### # ##### ##### # # ### ##### # # ### # ######### # ### ##### # ############# #
# # #   #         # #   # #     # # # #   #   # # # #   #   # #   #   # # #   #   #       #   #   #     #   #   #       #   #     #   # #   #   # #   #   #   # #   #       #   #   #   #   #   #   # #     #     #   #   # #
### ### ######### # # # ####### # # # ### # ### # # ### ### # # # # # ### # ####### ##### # # # ######### ### ### ######### # ### ### # ### ##### # # ### # ####### ####### ##### ####### # # ##### # # ######### # ### # ###
#     #   #   #   # # #       # # #     #       # #   # # # # # # # # #   #   #     #   #   # #   #       #   #   #   #   # #   #   #   # #     # # #   #   #     #       #     #     #   #       # # #     #   # # #   #   #
# ####### # # # ### ### ##### # # ##### ######### ### # # # # # # # # # ##### # ##### # ##### # ### # ##### ### ### ### # # ####### ##### ##### # # ### ### # ### ##### # ##### ##### # ########### # # ### # ### # # ##### #
#       #   # #   #   # #     # # #   # #   #     #   #   # #   #   # #     # # #     # # #   # #   # #   #   #     #   #   #     #     #   #   # #   #     # # #     # # #   #     #   # #   #   # # #   # #       # #   # #
# ##### ##### ### ### ### ##### # # ### # # # ##### ##### # ######### ##### # # # # ### # # ### # ##### # ### ##### # ####### ### ### # ### # ### ### ####### # ##### ### # ####### ##### # # # # # # ##### # ####### ### # #
# #     #   #   #     #   #     # #   # # # # #   # #   # #         #       # # # # #   # #     #     # #     #     #     #     #     # #   # #       #     # #     #     #   #   #       # #   #   #     # # #   #       # #
# # ##### # ### ####### ### ##### ### # # # # ### # # # # ##### ### ### ##### # ### # ### ########### # ################# # ### ####### # ### ##### ### ### # ### ######### # # # ####### # ####### ##### # ### # # ##### # #
# #       #           # #   #         # # # #   # #   # # #     #   #   #     #     # #   #     #   #   # #         #     #   # #     # # #   #   # #   # # #   #     #     #   #       # #   # #   #     #     #   #   # # #
# ########### ####### # # ##### ####### ### ### # ##### ### # ####### ### ########### # # ### ### # ##### # ### ### # ##### ### ##### # # # ### # ### ### # # # ##### # ########### ##### ### # # ### ##### ######### # ### #
#   #   #   # #   #     #     #   #     #     # #     #   # # #     # #   #       #   # #   #     #           # #   #   #   #   #   #   # #   # #     # #   # # #     # # #       #       # # #   #   #   # #   #     #   # #
### # # # # ### # ######### # ### # ##### ##### # ### ### # # # ### # # ### ### ### ### ### ########### ####### # ##### ##### ### # # ### ### # ####### # ##### # ##### # # ### # ######### # # ### ### ### # ### ####### # #
# #   # # # #   #     #   # # #   # #     #   # # # #   # # # #   #   #   #   #   # #   #   #         #     #   #     #     #     # #   #   #   #       # #     #       # #   # # #     #   # #   # #         #   #     #   #
# ##### # # # ####### # # ### ##### # # ### # # # # ### # # # ### ####### ### ### # ### # ### ####### ##### # ####### ##### # ##### ### # # ##### ##### # # ##### ####### ### # # # ### ### # ##### ######### # ### ####### #
#       # # # #     # # #     #     # # #   #   # #   #     # #   #   #     #   # #     #   #     # #     # #     #         #   #   #     # #   # # #   #   #   # #       #   # # #   #     # #     #     # # # #   #     # #
# ####### # # # ### # # ##### # ##### # # ####### # # ####### # ### # # ####### # ######### ##### # ##### ### ### ############# # ########### # # # # ####### # # ### # ### ### # ### ####### # ##### ### # # # # ### ### # #
# #     # #   #   #     #     #   #   # #     # #   # #   #   #     # # #     # #       #   #     #     #   # # #   #         # #   #         #   # #   #     # #   # #     # # #   #       #   #     # # #   # #   #   # # #
# ##### # ####### ############### # ### ##### # # ##### # ########### # # # ### ####### # ### ##### # ##### # # ### ### ####### ### # ############# ### # ##### ### # ##### # # ### # ##### ##### ##### # ### # # # ### # # #
#     # #       # #   #     #     # #   #     #   #     #           # #   #     #     #   #   # #   #     # #     #   #       #   #   #           #   #   # #   #   # #   #   # #   #   #     #   #     #   # # # #   # #   #
##### # ####### ### # # ### # ####### # # ######### ########### ##### ########### ### ##### ### # ####### # ######### # ##### ### ########### ### # # ##### # ### ##### # ##### # ####### ### # ### ### ### ### # ### # #####
#             #     #     #           # #                     #                   #         #           #             #     #                 #     #       #           #       #         #     #     #         #   #       #
#############################################################################################################################################################################################################################